"2","2",3,0.086,3,0.086
"2","3",1,0.029,4,0.114
"2","4",0,0,4,0.114
"3","2",5,0.143,9,0.257
"3","3",2,0.057,11,0.314
"3","4",2,0.057,13,0.371
"4","2",1,0.029,14,0.4
"4","3",5,0.143,19,0.543
"4","4",6,0.171,25,0.714
"5","2",2,0.057,27,0.771
"5","3",3,0.086,30,0.857
"5","4",5,0.143,35,1
