"2","2",3,0.086,3,0.086
"3","2",5,0.143,8,0.229
"4","2",1,0.029,9,0.257
"5","2",2,0.057,11,0.314
"2","3",1,0.029,12,0.343
"3","3",2,0.057,14,0.4
"4","3",5,0.143,19,0.543
"5","3",3,0.086,22,0.629
"2","4",0,0,22,0.629
"3","4",2,0.057,24,0.686
"4","4",6,0.171,30,0.857
"5","4",5,0.143,35,1
